########################
#      #          #    #
#                 #  * #
#      #        M #    #
#      #               #
### ####################
#     #  M        #    #
# #####  #######  #    #
# #      # M           #
# # ###  #        @    #
#   #    #             #
########################
